######################
#p                   #
#  ###   F   ###     #
#  # #       # #     #
#                    #
#  TTT   C   TTT     #
#  T T       T T     #
#       F            #
#  ######   ######   #
#                    #
#  LLLL      LLLL    #
#  L  #  C   L  #    #
#                    #
#       F            #
####################E#