########################
#p     F       F       #
#  ###    C    ###     #
#  # #         # #     #
#                      #
#  TTT    F    TTT     #
#  T T         T T     #
#        C             #
#  ######   ######     #
#     F                #
#  LLLL    C    LLLL   #
#  L  #    F    L  #   #
#                      #
#      F       F       #
######################E#